ллллллллллллллллллллллллллллллллллллллллллллллллллллллллллллллллллллллллллллллллллллллллллллллллллллллл
ллллллллллллллллллллллллллллллллллллллллллллллллллллллллллллллллллллл      лллллллл  лллллллллллллллллл
лллллллллллллллллллллллллллл    ллл    лллллллллллллллллллллллл              ллллл       лллллллллллллл
ллллллллллллл                               лллллллллл                  D     ллл   л      лллллллллллл
лллллл   лл                           л         ллллл    D       л                      D    лллллллллл
лллл      л               л                       лл        л          л D       D                ллллл
ллл           л                      л             л    D                              л           лллл
лл  *                                       л     ллл             D       D л      л        л        лл
лл                                      л        ллллл     л           л               D              л
лл                                                 л                D           D                     л
лл                                                     D    л    л         D           л   D         лл
ллллл                                                                   л    л  D                   ллл
ллллллл        л                                   л     л          D              л         л       лл
ллллллллл                                        ллллл       D    л     л               D            лл
лллллллл                                          ллл                        D    л                  лл
лллллллллл       л                         л       л   D    л                           л     D     ллл
лллллллллллл           л              л           лл           D   D  D   л       D                лллл
ллллллллллллл                                    лллл                        л             D  л      лл
ллллллллллллллллл               л             лллллллллллллл   л    D     л    л     D  л        лллллл
лллллллллллллллллл        л              ллллллллллллллллллллл    л     ллл    ллл          ллллллллллл
лллллллллллллллллллллл    лл     лллллллллллллллллллллллллллллллл    ллллл      ллллл   ллллллллллллллл
ллллллллллллллллллллллллллллллллллллллллллллллллллллллллллллллллллллллллллл    лллллллллллллллллллллллл
ллллллллллллллллллллллллллллллллллллллллллллллллллллллллллллллллл    ллллл      ллллл    лллллллллллллл
ллллллллллллллллллллллллллллллллллллллллллллллллллллллллллллл           ллл    ллл                   лл
ллллллллллллллллллллллллллллллллллллллллллллллллллллллл                   л    л                    ллл
лллллллллллллллллллллллллллллллллллллллллллллллллллллл                                             лллл
лллллллллллллллллллллллллллллллллллллллллллллллллллллл                                               лл
ллллллллллллллллллллллллллллллллллллллллллллллллллллл                                                лл
лллллллллллллллллллллллллллллллллллллллллллллллллллллл                                              ллл
ллллллллллллллллллллллллллллллллллллллллллллллллллллл                                                лл
ллллллллллллллллллллллллллллллллллллллллллллллллллллллл                                              лл
лллллллллллллллллллллллллллллллллллллллллллллллллллллл                                              ллл
ллллллллллллллллллллллллллллллллллллллллллллллллллллллллл                                         ллллл
лллллллллллллллллллллллллллллллллллллллллллллллллллллллллл                   B                  ллллллл
ллллллллллллллллллллллллллллллллллллллллллллллллллллллллллллл                               ллллллллллл
лллллллллллллллллллллллллллллллллллллллллллллллллллллллллллллллл                        ллллллллллллллл
ллллллллллллллллллллллллллллллллллллллллллллллллллллллллллллллллллл                  лллллллллллллллллл
ллллллллллллллллллллллллллллллллллллллллллллллллллллллллллллллллллллллллллллллллллллллллллллллллллллллл
ллллллллллллллллллллллллллллллллллллллллллллллллллллллллллллллллллллллллллллллллллллллллллллллллллллллл
ллллллллллллллллллллллллллллллллллллллллллллллллллллллллллллллллллллллллллллллллллллллллллллллллллллллл
ллллллллллллллллллллллллллллллллллллллллллллллллллллллллллллллллллллллллллллллллллллллллллллллллллллллл
ллллллллллллллллллллллллллллллллллллллллллллллллллллллллллллллллллллллллллллллллллллллллллллллллллллллл
ллллллллллллллллллллллллллллллллллллллллллллллллллллллллллллллллллллллллллллллллллллллллллллллллллллллл