лллллллллллллллллллллллллллллллллллллллллллллллллллллллллллллллллллллллллллллллллллллллллллллллллллллллллллллллллллллллл
ллллллллллллллллллллллллллллллллллллллллллллллллллллллллллллллллллллл      лллллллл  ллллллллллллллллллллллллллллллллллл
лллллллллллллллллллллллллллл    ллл    лллллллллллллллллллллллл              ллллл       ллллллллллллллллллллллллллллллл
ллллллллллллл                               лллллллллл                  E     ллл   л      ллллллллллллллллллллллллллллл
лллллл   лл                           л         ллллл    E       л                      E    ллллллллллллллллллллллллллл
лллл      л               л                       лл        л          л E       E                лллллллллллллллллллллл
ллл           л                      л             л    E                              л           ллллллллллллллллллллл
лл                                          л     ллл             E       E л      л        л        ллллллллллллллллллл
лл                                      л        ллллл     л           л               E              лллллллллллллллллл
лл                                                 л                E           E                     лллллллллллллллллл
лл                         @                           E    л    л         E           л   E         ллллллллллллллллллл
ллллл                                                                   л    л  E                   лллллллллллллллллллл
ллллллл        л                                   л     л          E              л         л       ллллллллллллллллллл
ллллллллл                                        ллллл       E    л     л               E            ллллллллллллллллллл
лллллллл                                          ллл                        E    л                  ллллллллллллллллллл
лллллллллл       л                         л       л   E    л                           л     E     лллллллллллллллллллл
лллллллллллл           л              л           лл           E   E  E   л       E                ллллллллллллллллллллл
ллллллллллллл                                    лллл                        л             E  л      ллллллллллллллллллл
ллллллллллллллллл               л             лллллллллллллл   л    E     л    л     E  л        ллллллллллллллллллллллл
лллллллллллллллллл        л              ллллллллллллллллллллл    л     ллл    ллл          лллллллллллллллллллллллллллл
лллллллллллллллллллллл    лл     лллллллллллллллллллллллллллллллл    ллллл      ллллл   лллллллллллллллллллллллллллллллл
ллллллллллллллллллллллллллллллллллллллллллллллллллллллллллллллллллллллллллл    ллллллллллллллллллллллллллллллллллллллллл
ллллллллллллллллллллллллллллллллллллллллллллллллллллллллллллллллл    ллллл      ллллл    ллллллллллллллллллллллллллллллл
ллллллллллллллллллллллллллллллллллллллллллллллллллллллллллллл           ллл    ллл                   ллллллллллллллллллл
ллллллллллллллллллллллллллллллллллллллллллллллллллллллл                   л    л                    лллллллллллллллллллл
лллллллллллллллллллллллллллллллллллллллллллллллллллллл                                             ллллллллллллллллллллл
                        лллллллллллллллллллллллллллллл                                               ллллллллллллллллллл
                        ллллллллллллллллллллллллллллл                                                ллллллллллллллллллл
                                                   ллл                                              лллллллллллллллллллл
                                                   лл                                                ллллллллллллллллллл
                                                   лллл                                              ллллллллллллллллллл
                                                   ллл                                              лллллллллллллллллллл
                                                   лллллл                                         лллллллллллллллллллллл
                                                   ллллллл                   B                  лллллллллллллллллллллллл
                                                   лллллллллл                               лллллллллллллллллллллллллллл
                                                   ллллллллллллл                        лллллллллллллллллллллллллллллллл
                                                   лллллллллллллллл                  ллллллллллллллллллллллллллллллллллл
                                                   ллллллллллллллллллллллллллллллллллллллллллллллллллллллллллллллллллллл
                                                   ллллллллллллллллллллллллллллллллллллллллллллллллллллллллллллллллллллл
                                                   ллллллллллллллллллллллллллллллллллллллллллллллллллллллллллллллллллллл
                                                   ллллллллллллллллллллллллллллллллллллллллллллллллллллллллллллллллллллл
                                                   ллллллллллллллллллллллллллллллллллллллллллллллллллллллллллллллллллллл
                                                   ллллллллллллллллллллллллллллллллллллллллллллллллллллллллллллллллллллл