ллллллллллллллллллллллллллллллллллллллллллллллллллллллллллллллллллллллллллллллллллллллллллллллллллллллл
лллллллллллл                                  ллллллллллллллллллллллллллллллллл          лллллллллллллл
ллллллллл                 л                      ллллллллллллллллллллл   лл      |        ллл        лл
лллл  л         л                                 ллллллллл               л                лллллл     л
л       л                         л                ллл             |        л       |       ллл       л
л                                                 ллл    л                                  л         л
л                                                  лл           |    л            л                   л
л         л          л             |        |     ллл                        E       E             |  л
л                                                ллллл                                     л          л
л     л                                            л         E                       л                л
л                    |                                               E         E                      л
л                                                                                            л     лллл
л      л      |                                    л      E                                 ллллллллллл
л                                                ллллл                            |          лл       л
л                 |                               ллл               |     E                       ллллл
л     л                                            л       л                              л        лллл
л        |                                        лл     E    |    E                  |          лллллл
лл                                $    %    !      лл       л  |                 л           л        л
лллл                                              ллл                                E  л           ллл
лллллл      |         л      л      л        л   ллллллллллл             л      л       лл       лллллл
ллллллллллллллл      лл      лл     лл    лллллллллллллллллллллллл      лл      лл    ллл      лллллллл
лллллллллллллллллллллллл    ллллллллллллллллллллллллллллллллллллллллллллллл    лллллллллллллллллллллллл
лллллллллллллл       лл      лл      ллллллллллллллллллллллл            лл      лл    лл  ллллллллллллл
ллл л  ллллл          л      л            лллллллллл     лллл      л     л      л      л      ллллллллл
лл       ллл                      |             лллл      лл                           л         лллллл
л    |     лл  |                          |       лл      л       |                      л        ллллл
л          л                           л           лл           л    л                              ллл
л                                                  лллл                         E            |       лл
л                                                 ллл        |                       |                л
л          л                               л     ллллл                  E                             л
л                                                  л          E                          л            л
л    |                     B        B                                                          |      л
л                                                       E                       E                     л
лл                                                 л            E       E              л      E       л
ллл        л                                     ллллл                                                л
лл                                                ллл         л                                 ллл   л
лл        |         |                        |     л             л           E            л       л  лл
л                                                 ллл         |                    л              ллллл
л                                        л         лл   |         лл   л                 |        ллллл
л             л                     |              лллл            лл         л               ллллллллл
ллл         |               |          л      лллллллллл           ллл        лл                   лллл
ллллллллллллллллллллллллллл           лл    ллллллллллллллл       ллл        лл       ллллллллллллллллл
ллллллллллллллллллллллллллллллллллллллллллллллллллллллллллллллллллллллллллллллллллллллллллллллллллллллл