ллллллллллллллллллллллллллллллллллллллллллллллллллллллллллллллллллллллллллллллллллллллллллллллллллллллл
л                                                  л                                                  л
л                   А          л          ллл      л                                                  л
л       лл         АБА                    лл       л                                                  л
л                 ББВББ                            л                                                  л
л                ББВВВББ                           л                                                  л
л     л           АВКВА      л           ААА       л             *                 (                  л
л                   К                   АБВБА      л                                                  л
л                   Ъ            лл    АБВВВБА   еЭлЭИ                                                л
л        ААА                                                                   *                      л
л       АБВБА                                                                                         л
л      АБВВВБА     A                                                                                  л
л                                                                                                     л
л         А                                      дЭлЭО                                (               л
л    л   АБА      лл                               л                 *                                л
л       ББВББ     л                                л                                                  л
л      ББВВВББ                                     л                              *                   л
л       АВКВА                      ж             З л          (                                       л
л         К                        К  !   $   %  К л                                                  л
л  л      Ъ           ж      З     ШЭЭЭЭЭЭЭЭЭЭЭЭЭМ л                     ж      З                     л
л                     К      К                     л                     К      К                     л
ллллллллллллллллллллллл      ллллллллллллллллллллллллллллллллллллллллллллл      ллллллллллллллллллллллл
л                     К      К                     л                     К      К                     л
л                     г      Н         )           л                     г      Н                     л
л                                                  л                                         &        л
л                                                  л                                                  л
л         )                                        л          &                                       л
л                                                  л                                                  л
л                                                  л                                                  л
л                                    )           еЭлЭИ                    &               &           л
л    /                                                                                                л
л                                         /                                                           л
л                 )                                                                                   л
л                         /                                                                           л
л                                                дЭлЭО                  &                             л
л                                    )             л                                                  л
л        )                                         л                                                  л
л                                                  л                                      &           л
л                                                  л       &                                          л
л               )             /                    л                                                  л
л                                                  л                                                  л
л                                                  л                                                  л
ллллллллллллллллллллллллллллллллллллллллллллллллллллллллллллллллллллллллллллллллллллллллллллллллллллллл