ЫЫЫЫЫЫЫЫЫЫЫЫЫЫЫЫЫЫЫЫЫЫЫЫЫЫЫЫЫЫЫЫЫЫЫЫЫЫЫЫЫЫЫЫЫЫЫЫЫЫЫЫЫЫЫЫЫЫЫЫЫЫЫЫЫЫЫЫЫЫЫЫЫЫЫЫЫЫЫЫЫЫЫЫЫЫЫЫЫЫЫЫЫЫЫЫЫЫЫЫЫЫЫ
Ы                                                  Ы                                                  Ы
Ы                   °          Ы          ЫЫЫ      Ы                                                  Ы
Ы       ЫЫ         °±°                    ЫЫ       Ы                                                  Ы
Ы                 ±±І±±                            Ы                                                  Ы
Ы                ±±ІІІ±±                           Ы                                                  Ы
Ы     Ы           °ІєІ°      Ы           °°°       Ы             *                 (                  Ы
Ы                   є                   °±І±°      Ы                                                  Ы
Ы                   К            ЫЫ    °±ІІІ±°   ХНЫНё                                                Ы
Ы        °°°                                                                   *                      Ы
Ы       °±І±°                                                                                         Ы
Ы      °±ІІІ±°                                                                                        Ы
Ы                                                                                                     Ы
Ы         °                                      ФНЫНѕ                                (               Ы
Ы    Ы   °±°      ЫЫ                               Ы                 *                                Ы
Ы       ±±І±±     Ы                                Ы                                                  Ы
Ы      ±±ІІІ±±                                     Ы                              *                   Ы
Ы       °ІєІ°                      Ц             · Ы          (                                       Ы
Ы         є                        є  !   $   %  є Ы                                                  Ы
Ы  Ы      К           Ц      ·     ИНННННННННННННј Ы                     Ц      ·                     Ы
Ы                     є      є                     Ы                     є      є                     Ы
ЫЫЫЫЫЫЫЫЫЫЫЫЫЫЫЫЫЫЫЫЫЫЫ      ЫЫЫЫЫЫЫЫЫЫЫЫЫЫЫЫЫЫЫЫЫЫЫЫЫЫЫЫЫЫЫЫЫЫЫЫЫЫЫЫЫЫЫЫЫ      ЫЫЫЫЫЫЫЫЫЫЫЫЫЫЫЫЫЫЫЫЫЫЫ
Ы                     є      є                     Ы                     є      є                     Ы
Ы                     У      Ѕ         )           Ы                     У      Ѕ                     Ы
Ы                                                  Ы                                         &        Ы
Ы                                                  Ы                                                  Ы
Ы         )                                        Ы          &                                       Ы
Ы                                                  Ы                                                  Ы
Ы                                                  Ы                                                  Ы
Ы                                    )           ХНЫНё                    &               &           Ы
Ы    /                                                                                                Ы
Ы                                         /                                                           Ы
Ы                 )                                                                                   Ы
Ы                         /                                                                           Ы
Ы                                                ФНЫНѕ                  &                             Ы
Ы                                    )             Ы                                                  Ы
Ы        )                                         Ы                                                  Ы
Ы                                                  Ы                                      &           Ы
Ы                                                  Ы       &                                          Ы
Ы               )             /                    Ы                                                  Ы
Ы                                                  Ы                                                  Ы
Ы                                                  Ы                                                  Ы
ЫЫЫЫЫЫЫЫЫЫЫЫЫЫЫЫЫЫЫЫЫЫЫЫЫЫЫЫЫЫЫЫЫЫЫЫЫЫЫЫЫЫЫЫЫЫЫЫЫЫЫЫЫЫЫЫЫЫЫЫЫЫЫЫЫЫЫЫЫЫЫЫЫЫЫЫЫЫЫЫЫЫЫЫЫЫЫЫЫЫЫЫЫЫЫЫЫЫЫЫЫЫЫ